2 2 1 5 3
2 3 1 4 5
1 1 1 3 5
1 3 5 4 2
5 4 3 2 1
